....................
....................
..........#.........
..........#.........
..........#.........
..........#.........
.....##########.....
....................
....................
.........###........
....................
.........$..........
..........#.........
..........#.........
....#######.........
..........#.........
..........#.........
....................
....................
....................