....................
....###########.....
....................
....................
....................
....................
....................
....................
....................
....###########.....
....................
.........$..........
....................
....................
....................
....................
....................
....................
....................
....................